#########
#..@....#
.#.#.#.#.#
####.####
.....####
####.....#
########.