#########
#.......#
.#.#.#.#.#
####.####
.....####
####.....#
########.